0 0 6 1 1 1 1 1 2
0 0 1 0 1 0 1 0
0 0 1 1 1 1 1 0 0 1 1 1
0 0 0 1 0 1 0 0 0 1 1 1
0 0 0 1 0 1 0 0 0 1 1
0 0 0 1 0 1 0 0 0 1 1
0 0 0 1 1 1 0 0 0 1
0 0 1 0 1 0 0 0 0 1 1
0 0 8 0 1 0 0 0 0 0 1
0 0 7 0 1 0 0 0 0 0 1
0 0 1 1 1 1 1 1 1 1 1
0 9 1 0 1 0 0 0
0 0 1 0 1 0 0 0
0 10 1 0 1 0 0 0
0 0 1 0 1 0 0 0
0 1 1 0 1
0 0 1 0 1
0 1 1 0 1
0 0 0 1 1 1 1
